2222222222222222222222222222222222222222222222222222222222222222222222222222222222222222222222222222
2wwwww2wwwww2wwwww2wwwww22wwwww2wwwww2wwwww2wwwww22wwwww2wwwww2wwwww2wwwww22wwwww2wwwww2wwwww2wwwww2
2222222222222222222222222222222222222222222222222222222222222222222222222222222222222222222222222222
2zz2zz2x1x1x1x1x1x2zz2zz22zz2zz2x1x1x1x1x1x2zz2zz22zz2zz2x1x1x1x1x1x2zz2zz22zz2zz2x1x1x1x1x1x2zz2zz2
2zz2zz2111111111112zz2zz22zz2zz2111111111112zz2zz22zz2zz2111111111112zz2zz22zz2zz2111111111112zz2zz2
2222222x1x1x1x1x1x22222222222222x1x1x1x1x1x22222222222222x1x1x1x1x1x22222222222222x1x1x1x1x1x2222222
2wwwww2111111111112wwwww22wwwww2111111111112wwwww22wwwww2111111111112wwwww22wwwww2111111111112wwwww2
2222222x1x1x1x1x1x22222222222222x1x1x1x1x1x22222222222222x1x1x1x1x1x22222222222222x1x1x1x1x1x2222222
2zz2zz2111111111112zz2zz22zz2zz2111111111112zz2zz22zz2zz2111111111112zz2zz22zz2zz2111111111112zz2zz2
2zz2zz2x1x1x1x1x1x2zz2zz22zz2zz2x1x1x1x1x1x2zz2zz22zz2zz2x1x1x1x1x1x2zz2zz22zz2zz2x1x1x1x1x1x2zz2zz2
2222222222222222222222222222222222222222222222222222222222222222222222222222222222222222222222222222
2wwwww2wwwww2wwwww2wwwww22wwwww2wwwww2wwwww2wwwww22wwwww2wwwww2wwwww2wwwww22wwwww2wwwww2wwwww2wwwww2
2222222222222222222222222222222222222222222222222222222222222222222222222222222222222222222222222222
1111111111111111111111111111111111111111111111111111111111111111111111111111111111111111111111111111
111111111xx11xx1111111111111111111xx11xx1111111111111111111xx11xx1111111111111111111xx11xx1111111111
111111111xx11xx1111111111111111111xx11xx1111111111111111111xx11xx1111111111111111111xx11xx1111111111
1111111111111111111111111111111111111111111111111111111111111111111111111111111111111111111111111111
11111111w11111w111111111111111111w11111w111111111111111111w11111w111111111111111111w11111w1111111111
111111111wwwww11111111111111111111wwwww11111111111111111111wwwww11111111111111111111wwwww11111111111
1111111111111111111111111111111111111111111111111111111111111111111111111111111111111111111111111111
1111111111111111111111111111111111111111111111111111111111111111111111111111111111111111111111111111
2222222222222222222222222222222222222222222222222222222222222222222222222222222222222222222222222222
2wwwww2wwwww2wwwww2wwwww22wwwww2wwwww2wwwww2wwwww22wwwww2wwwww2wwwww2wwwww22wwwww2wwwww2wwwww2wwwww2
2222222222222222222222222222222222222222222222222222222222222222222222222222222222222222222222222222
2zz2zz2x1x1x1x1x1x2zz2zz22zz2zz2x1x1x1x1x1x2zz2zz22zz2zz2x1x1x1x1x1x2zz2zz22zz2zz2x1x1x1x1x1x2zz2zz2
2zz2zz2111111111112zz2zz22zz2zz2111111111112zz2zz22zz2zz2111111111112zz2zz22zz2zz2111111111112zz2zz2
2222222x1x1x1x1x1x22222222222222x1x1x1x1x1x22222222222222x1x1x1x1x1x22222222222222x1x1x1x1x1x2222222
2wwwww2111111111112wwwww22wwwww2111111111112wwwww22wwwww2111111111112wwwww22wwwww2111111111112wwwww2
2222222x1x1x1x1x1x22222222222222x1x1x1x1x1x22222222222222x1x1x1x1x1x22222222222222x1x1x1x1x1x2222222
2zz2zz2111111111112zz2zz22zz2zz2111111111112zz2zz22zz2zz2111111111112zz2zz22zz2zz2111111111112zz2zz2
2zz2zz2x1x1x1x1x1x2zz2zz22zz2zz2x1x1x1x1x1x2zz2zz22zz2zz2x1x1x1x1x1x2zz2zz22zz2zz2x1x1x1x1x1x2zz2zz2
2222222222222222222222222222222222222222222222222222222222222222222222222222222222222222222222222222
2wwwww2wwwww2wwwww2wwwww22wwwww2wwwww2wwwww2wwwww22wwwww2wwwww2wwwww2wwwww22wwwww2wwwww2wwwww2wwwww2
2222222222222222222222222222222222222222222222222222222222222222222222222222222222222222222222222222
1111111111111111111111111111111111111111111111111111111111111111111111111111111111111111111111111111
111111111xx11xx1111111111111111111xx11xx1111111111111111111xx11xx1111111111111111111xx11xx1111111111
111111111xx11xx1111111111111111111xx11xx1111111111111111111xx11xx1111111111111111111xx11xx1111111111
1111111111111111111111111111111111111111111111111111111111111111111111111111111111111111111111111111
11111111w11111w111111111111111111w11111w111111111111111111w11111w111111111111111111w11111w1111111111
111111111wwwww11111111111111111111wwwww11111111111111111111wwwww11111111111111111111wwwww11111111111
1111111111111111111111111111111111111111111111111111111111111111111111111111111111111111111111111111
1111111111111111111111111111111111111111111111111111111111111111111111111111111111111111111111111111
